1111111111111111111111111111111111111
1000000000000000000000000000000000001
11E1000000000111111101111111111111111
1010000000111111110001111000111111111
100000001111111P000001000000111111111
1000011111111000000000000000111111101
1001111111000000000000000111111110001
1011111100000000000000011111110000001
1011110000000000000001111111000000001
1011111111111111111101111111000001111
1011111111111111111101111111000111111
1000000000000111111101111111011111111
1000000000000111111100000000000000001
100000000000011111110000C000000000001
1111111111111111111111111111111111111
