1111111111111111111111111111111111
1E0000000000000C00000C000000000001
100001010C100000101001000000010101
1010010010101010001001000000000111
1P0000000C00C000000100000101000001
100000100000C00C00000C000000000001
1010010100100000101001000000010101
101001001010101010100100000101C111
100000C00C00C01C100100000001000001
101001001010101010100100000101C111
100000C00C00C01C100100000001000001
101001001010101010100100000101C111
100000C00C00C01C100100000001000001
101001001010101010100100000101C111
100000C00C00C01C100100000001000001
101001001010101010100100000101C111
100000C00C00C01C100100000001000001
1111111111111111111111111111111111
