111111111
111110001
111100001
1111000E1
1C00100P1
111111111
