1111
1P01
1C01
1011
1E11
1111
